█████████
█A      █
█  ████ █
█  █    █
█  █ ████
█      B█
█████████
